CC.CCCC(CC(CC(C(=O)C(C(C(O)C)O)C)C)(O)C)C.CCCO.CNC.CO.COC=O.COCC.OCC(C)C	Erythromycin
CC.CC=O.CCC.CCCC(C(C(=O)C)O)(CCO)O.COCC.O=c1cc(O)c2c(o1)c(Cl)c(cc2)O.OC1COCC(=O)c2c1c(O)ccc2	Simocyclinone_D8
C=O.CC([N+](=O)[O-])(C)C.CCOCC(=O)c1c(cc(c(c1C(=O)CC)O)C)C(=O)C.CO.COCC.O=CC(CC(C)C)O.O=c1cc(O)c2c(o1)cccc2.Oc1cccnc1	Rubradirin
CC(O)C.CCC.CCCO.COCC.OC1CC(=O)c2cccc(c2C(=O)Cc2c(C1)cc(C)cc2O)O	Landomycin_A
CCC.CCC(=O)c1c(O)cccc1C(=O)CC1C(=O)CC(CC1(C)O)(C)O.CCCO.COCC.OCC(O)C	Urdamycin_A
C=O.CC.CC#CC(CC(=O)CN)(CCCC#CC)O.CC(O)C.CCC.CO.COC.COCC.CSSS.Cc1ccccc1I.OCCCO.ONCC(O)C.SC=O	Calicheamicin
C=O.CC(CC(=O)O)C.CC(O)C.CCC.CCCCCC(C(C1CCCCC1C)C)C.CCCO.CO.COCC.Cc1ccccc1Cl.OCCOC(=O)COC=O	Chlorothricin
C=O.CC(O)(C)C.CCC.COCC.COCC(=O)c1c(C)c2CC(O)(CC(=O)CC(=O)C)C(C(=O)c2c(c1C(=O)C)O)(O)CO.Cc1ccc(c(c1)O)C	Polyketomycin
C=O.CC=O.CCC.CCCCCC.CCCCCCCCC=O.CCCO.CCO.CO.OCCO.Oc1ccccc1	Echinocandin_B
C=O.CC.CC=O.CCC(=O)N.CCCC.CCCC(O)C.CO.c1ccccc1	Nostophycin
CN=C(c1cccc(c1O)O)O.COC=O	Enterobactin
C=O.CC(=O)N.CC=O.CN.CO.COC.COCC.Clc1cc(ccc1Oc1cccc(c1)Oc1ccc(cc1Cl)C(O)C)C(O)C.O=CCCC(C)C.OC(=O)C(c1cc(O)cc(c1)O)N.OCC(N)(C)C.OCC(O)C.Oc1ccccc1	Vancomycin
CC(C=O)O.CCC(CC=O)O.CCC=O.O=CCCCCN=C(N)N.OCCC(=O)O.c1ccc2c(c1)[nH]cc2.c1ccccc1	Kasumigamide
C=O.CCCO.CO.COC(C)C.Cc1c[nH]cc1.Cc1ccc[nH]1.O=c1cc(O)c2c(o1)c(C)ccc2	Coumermycin_A1
C=CC=O.C=O.CC.CCC.CCC(=O)N.CCC(C(=O)C)C.CCCCCCC(CCC)C.COC(=O)C	Fusaristatin_A
C=O.CC=O.CCC.CCC(=O)N.CCC=O.CCCCCCCCCCCC.CCO.COC(=O)C.Oc1ccccc1	W439_B
CC.CC(CC(C(C)C)O)O.CC(CC(C(O)C)O)O.CC=O.CCC.CCCCC.CCCCC(CCC)C.COC=O	Mycolactone
C=O.CCC.CCC=O.CCOC=O.CN.CSCS(=O)C.Oc1cnc2c(c1)cccc2	Retimycin_A
C=O.CC.CC(C)C.CC=O.CCC.CCC=O.CCCCCCCCCC=O.CSC	Mutanamide
C=O.CC.CCC.CCCO.CO.COC(C)C.NC=O.O=c1cc(O)c2c(o1)c(C)ccc2.Oc1ccccc1	Novobiocin
C=O.CC=O.CCC.CCC(CCCCCCCC(C)C)C.CCCC(=O)O.CO.COC.OCC(O)C.OCC(CO)O.OCCO.OP(=O)(O)O	Uridine_der_nucleoside
C=O.CCC=O.CO.NS(=O)(=O)O.O=CCCC(C(=O)O)N	Sulfazecin
